Variety,Group,Arrivals (Tonnes),Min Price (Rs./Quintal),Max Price (Rs./Quintal),Modal Price (Rs./Quintal),Reported Date,Days,Price Range,Demand Indicator
Local,Vegetables,116.8,600,2500,1550,2024-06-17,167,1900,0.07530625402965828
Local,Vegetables,133.2,2000,4000,3000,2024-06-20,170,2000,0.04438520493168943
Local,Vegetables,138.6,2500,5000,3750,2024-05-29,148,2500,0.03695014662756598
Local,Vegetables,144.0,1000,2200,1600,2024-10-21,293,1200,0.08994378513429106
Local,Vegetables,161.3,1000,4500,2750,2024-03-18,76,3500,0.058633224282079247
Local,Vegetables,170.8,1000,1600,1300,2024-10-28,300,600,0.1312836279784781
Local,Vegetables,179.2,600,3000,1800,2024-01-23,21,2400,0.09950027762354247
Local,Vegetables,196.5,500,1200,850,2025-03-15,438,700,0.2309048178613396
Local,Vegetables,206.4,1000,1800,1400,2024-08-01,212,800,0.14732334047109208
Local,Vegetables,220.5,600,2500,1550,2024-05-15,134,1900,0.14216634429400388
Local,Vegetables,232.3,600,1400,1000,2024-11-08,311,800,0.23206793206793208
Local,Vegetables,261.1,600,2000,1300,2024-10-07,279,1400,0.20069177555726367
Local,Vegetables,109.5,1500,6000,3750,2024-07-22,202,4500,0.029192215409224207
Local,Vegetables,118.7,2500,6500,4500,2024-10-02,274,4000,0.026371917351699622
Local,Vegetables,136.4,1000,4500,2750,2024-10-10,282,3500,0.04958197019265722
Local,Vegetables,165.7,1500,4500,3000,2024-08-20,231,3000,0.05521492835721426
Local,Vegetables,173.1,1000,3000,2000,2024-04-19,108,2000,0.08650674662668666
Local,Vegetables,176.6,600,1400,1000,2024-09-12,254,800,0.17642357642357642
Local,Vegetables,176.6,600,2000,1300,2024-12-24,357,1400,0.13574173712528823
Local,Vegetables,191.5,1000,2500,1750,2024-05-28,147,1500,0.10936607652769846
Local,Vegetables,191.6,1000,2200,1600,2024-02-27,56,1200,0.11967520299812617
Local,Vegetables,211.6,600,1200,900,2025-11-05,673,600,0.234850166481687
Local,Vegetables,217.5,600,2000,1550,2024-07-26,206,1400,0.1402321083172147
Local,Vegetables,222.8,1500,4500,3000,2024-08-18,229,3000,0.07424191936021327
Local,Vegetables,259.4,1000,1600,1300,2024-03-31,89,600,0.1993850883935434
Local,Vegetables,298.3,600,1400,1000,2024-01-19,17,800,0.298001998001998
Local,Vegetables,317.3,500,1000,750,2025-08-11,587,500,0.42250332889480696
Local,Vegetables,331.7,600,2000,1300,2024-01-12,10,1400,0.2549577248270561
Local,Vegetables,2996.0,600,1500,1050,2025-10-29,666,900,2.850618458610847
Local,Vegetables,0.3,4000,7000,5500,2024-09-03,245,3000,5.4535538992910375e-05
Local,Vegetables,99.8,600,2000,1300,2024-06-03,153,1400,0.07671022290545734
Local,Vegetables,108.1,1200,3500,2350,2024-07-15,195,2300,0.045980433857932795
Local,Vegetables,112.4,2000,6000,4000,2024-08-21,232,4000,0.028092976755811048
Local,Vegetables,120.8,1000,3000,2000,2024-01-20,18,2000,0.060369815092453774
Local,Vegetables,137.4,600,1200,900,2025-08-05,581,600,0.15249722530521642
Local,Vegetables,150.5,1000,2000,1500,2024-10-09,281,1000,0.10026648900732844
Local,Vegetables,161.7,1000,4500,2750,2024-07-31,211,3500,0.05877862595419847
Local,Vegetables,163.8,1000,3000,2000,2024-09-23,265,2000,0.08185907046476762
Local,Vegetables,177.1,1000,3500,2250,2024-11-06,309,2500,0.07867614393602843
Local,Vegetables,180.0,600,2500,1550,2024-02-18,47,1900,0.11605415860735009
Local,Vegetables,182.5,600,1200,900,2025-03-06,429,600,0.2025527192008879
Local,Vegetables,190.7,600,1600,1100,2024-11-12,315,1000,0.17320617620345138
Local,Vegetables,192.2,1000,2500,1750,2024-09-06,248,1500,0.10976584808680753
Local,Vegetables,194.3,600,2000,1300,2024-06-18,168,1400,0.1493466564181399
Local,Vegetables,198.6,1500,4000,2750,2024-12-20,353,2500,0.07219193020719739
Local,Vegetables,198.8,1000,2500,1750,2024-03-14,72,1500,0.11353512278697887
Local,Vegetables,206.6,1000,1600,1300,2024-10-24,296,600,0.15880092236740967
Local,Vegetables,210.0,1000,4000,2500,2024-03-27,85,3000,0.08396641343462614
Local,Vegetables,215.7,600,1400,1000,2024-04-21,110,800,0.21548451548451547
Local,Vegetables,234.8,600,1500,1050,2024-11-10,313,900,0.22340627973358707
Local,Vegetables,262.8,600,2000,1300,2024-01-10,8,1400,0.20199846272098387
Local,Vegetables,277.5,500,1400,950,2025-12-26,724,900,0.2917981072555205
Local,Vegetables,280.9,1000,2200,1600,2024-12-13,346,1200,0.17545284197376637
Local,Vegetables,281.6,600,2000,1300,2024-01-24,22,1400,0.21644888547271332
Local,Vegetables,283.0,600,1200,900,2025-09-25,632,600,0.31409544950055496
Local,Vegetables,95.7,1000,3000,2000,2024-10-16,288,2000,0.04782608695652174
Local,Vegetables,123.3,1000,4000,2500,2024-06-26,176,3000,0.04930027988804478
Local,Vegetables,133.2,2000,4000,3000,2024-10-18,290,2000,0.04438520493168943
Local,Vegetables,158.7,1000,4500,2750,2024-10-04,276,3500,0.05768811341330425
Local,Vegetables,164.6,1000,5000,3000,2024-02-19,48,4000,0.054848383872042654
Local,Vegetables,167.2,500,1200,850,2025-05-09,493,700,0.19647473560517037
Local,Vegetables,169.3,600,1400,1000,2024-12-11,344,800,0.16913086913086914
Local,Vegetables,171.8,600,3000,1800,2024-05-08,127,2400,0.09539144919489173
Local,Vegetables,172.5,600,1400,1000,2024-04-08,97,800,0.17232767232767232
Local,Vegetables,174.5,600,1200,900,2024-07-19,199,600,0.1936736958934517
Local,Vegetables,203.9,2000,6500,4250,2024-09-10,252,4500,0.04796518466243237
Local,Vegetables,205.7,600,2000,1300,2024-07-05,185,1400,0.15810914681014604
Local,Vegetables,211.2,2000,5500,3750,2024-07-29,209,3500,0.0563049853372434
Local,Vegetables,218.9,1000,4000,2500,2024-11-21,324,3000,0.08752499000399841
Local,Vegetables,252.1,1000,2500,1750,2024-09-19,261,1500,0.14397487150199886
Local,Vegetables,253.2,1000,3500,2250,2024-01-16,14,2500,0.11248334073745002
Local,Vegetables,327.3,600,1200,900,2025-01-17,381,600,0.3632630410654828
Local,Vegetables,350.7,500,1200,850,2025-12-08,706,700,0.41210340775558163
Local,Vegetables,355.9,1000,2500,1750,2024-02-03,32,1500,0.2032552826956025
Local,Vegetables,734.0,600,1200,900,2025-01-14,378,600,0.8146503884572697
Local,Vegetables,113.4,800,1500,1150,2025-06-06,521,700,0.09852302345786274
Local,Vegetables,123.2,1000,2800,1900,2024-12-04,337,1800,0.06480799579168858
Local,Vegetables,123.7,1000,3000,2000,2024-09-27,269,2000,0.061819090454772616
Local,Vegetables,165.4,1000,3500,2250,2024-10-23,295,2500,0.07347845402043536
Local,Vegetables,167.6,1500,4000,2750,2024-06-13,163,2500,0.0609233006179571
Local,Vegetables,170.0,1000,3500,2250,2024-04-16,105,2500,0.07552199022656597
Local,Vegetables,175.2,600,1200,900,2024-06-27,177,600,0.19445061043285236
Local,Vegetables,196.2,1500,4000,2750,2024-08-08,219,2500,0.071319520174482
Local,Vegetables,205.7,1000,2500,1750,2024-08-28,239,1500,0.1174757281553398
Local,Vegetables,213.2,600,2000,1300,2024-12-30,363,1400,0.1638739431206764
Local,Vegetables,223.2,500,2000,1250,2024-01-30,28,1500,0.17841726618705034
Local,Vegetables,229.9,600,1200,900,2025-01-28,392,600,0.2551609322974473
Local,Vegetables,237.6,6000,15000,10500,2025-06-14,529,9000,0.02262641653175888
Local,Vegetables,245.2,1500,3500,2500,2024-12-27,360,2000,0.09804078368652538
Local,Vegetables,257.7,600,2000,1300,2024-08-30,241,1400,0.1980784012298232
Local,Vegetables,261.3,1000,1600,1300,2024-07-17,197,600,0.2008455034588778
Local,Vegetables,58.4,3000,7500,5220,2024-06-12,162,4500,0.011185596628998276
Local,Vegetables,107.4,1500,4500,3000,2024-12-23,356,3000,0.03578807064311896
Local,Vegetables,142.7,1000,2500,1750,2024-11-18,321,1500,0.08149628783552255
Local,Vegetables,143.7,1000,2500,1750,2024-07-08,188,1500,0.08206739006282124
Local,Vegetables,158.5,1200,5500,3350,2024-08-12,223,4300,0.04729931363772008
Local,Vegetables,158.8,1000,2500,1750,2024-09-17,259,1500,0.09069103369503141
Local,Vegetables,165.0,1000,3200,2100,2024-02-24,53,2200,0.07853403141361257
Local,Vegetables,165.1,600,1200,900,2025-12-03,701,600,0.1832408435072142
Local,Vegetables,168.4,1000,3000,2000,2024-10-17,289,2000,0.08415792103948026
Local,Vegetables,172.5,1000,3500,2250,2024-10-01,273,2500,0.07663260772989783
Local,Vegetables,184.6,1500,5000,3250,2024-05-07,126,3500,0.056782528452783754
Local,Vegetables,188.7,600,1400,1000,2024-02-28,57,800,0.1885114885114885
Local,Vegetables,202.2,1000,2200,1600,2024-05-10,129,1200,0.12629606495940038
Local,Vegetables,204.7,600,1500,1050,2024-03-12,70,900,0.19476688867745004
Local,Vegetables,213.5,1000,1800,1400,2024-08-14,225,800,0.15239114917915775
Local,Vegetables,215.0,600,2500,1550,2024-11-15,318,1900,0.13862024500322373
Local,Vegetables,217.0,800,2500,1650,2024-09-13,255,1700,0.13143549364021806
Local,Vegetables,218.3,600,2000,1300,2024-05-23,142,1400,0.16779400461183705
Local,Vegetables,226.9,800,1800,1300,2024-04-05,94,1000,0.1744043043812452
Local,Vegetables,230.0,600,1200,900,2024-10-06,278,600,0.25527192008879024
Local,Vegetables,241.4,1400,6000,3700,2024-01-21,19,4600,0.06522561469873008
Local,Vegetables,241.8,400,1200,800,2025-01-29,393,800,0.30187265917602996
Local,Vegetables,249.5,6000,15000,10500,2025-08-23,599,9000,0.023759641938862965
Local,Vegetables,302.4,700,2500,1600,2024-01-05,3,1800,0.18888194878201123
Local,Vegetables,389.8,500,1500,1000,2025-12-02,700,1000,0.3894105894105894
Local,Vegetables,154.0,1000,3000,2000,2024-04-24,113,2000,0.0769615192403798
Local,Vegetables,155.1,700,1200,950,2024-07-04,184,500,0.16309148264984227
Local,Vegetables,157.5,2000,5000,3500,2024-09-24,266,3000,0.04498714652956298
Local,Vegetables,176.6,600,1200,900,2024-09-09,251,600,0.19600443951165372
Local,Vegetables,184.7,600,2000,1300,2024-03-05,63,1400,0.14196771714066103
Local,Vegetables,192.9,800,1400,1100,2024-01-02,0,600,0.17520435967302453
Local,Vegetables,200.6,500,1400,950,2025-10-14,651,900,0.2109358569926393
Local,Vegetables,200.9,1000,4000,2500,2024-12-25,358,3000,0.08032786885245902
Local,Vegetables,207.8,1000,2500,1750,2024-10-15,287,1500,0.11867504283266705
Local,Vegetables,210.3,1000,4000,2500,2024-12-22,355,3000,0.08408636545381848
Local,Vegetables,236.0,1000,2500,1750,2024-03-26,84,1500,0.13478012564249
Local,Vegetables,237.4,600,1400,1000,2024-10-13,285,800,0.23716283716283718
Local,Vegetables,249.8,1500,5000,3250,2024-08-02,213,3500,0.07683789603199016
Local,Vegetables,254.9,1000,2500,1750,2024-04-14,103,1500,0.14557395773843518
Local,Vegetables,261.0,500,1200,850,2024-10-20,292,700,0.30669800235017625
Local,Vegetables,273.0,1000,5000,3000,2024-05-26,145,4000,0.09096967677440854
Local,Vegetables,277.3,1000,1800,1400,2024-02-09,38,800,0.1979300499643112
Local,Vegetables,332.1,400,1200,800,2025-05-31,515,800,0.41460674157303373
Local,Vegetables,22.2,600,1600,1100,2024-03-04,62,1000,0.020163487738419618
Local,Vegetables,131.2,700,1200,950,2024-10-31,303,500,0.1379600420609884
Local,Vegetables,139.1,1000,2500,1750,2024-06-25,175,1500,0.07944031981724728
Local,Vegetables,159.9,1300,4000,2650,2024-07-03,183,2700,0.060316861561674845
Local,Vegetables,161.5,1500,5000,3250,2024-12-19,352,3500,0.04967702245462934
Local,Vegetables,162.1,600,2200,1400,2024-07-23,203,1600,0.11570306923625981
Local,Vegetables,167.6,1500,6000,3750,2024-11-13,316,4500,0.04468141828845641
Local,Vegetables,175.5,1000,2500,1750,2024-01-08,6,1500,0.10022844089091948
Local,Vegetables,184.9,600,1500,1050,2025-08-27,603,900,0.17592768791627023
Local,Vegetables,191.5,600,2000,1300,2024-06-04,154,1400,0.14719446579554188
Local,Vegetables,197.1,1000,4000,2500,2024-02-06,35,3000,0.07880847660935625
Local,Vegetables,207.8,400,1000,700,2025-03-22,445,600,0.2964336661911555
Local,Vegetables,211.5,600,1600,1100,2024-01-27,25,1000,0.19209809264305178
Local,Vegetables,222.0,600,1400,900,2025-08-09,585,800,0.24639289678135406
Local,Vegetables,240.2,600,2200,1400,2024-08-29,240,1600,0.17144896502498214
Local,Vegetables,241.4,600,2500,1550,2024-12-06,339,1900,0.1556415215989684
Local,Vegetables,258.3,1000,3000,2000,2024-11-24,327,2000,0.12908545727136433
Local,Vegetables,261.2,1000,2500,1750,2024-05-14,133,1500,0.1491719017704169
Local,Vegetables,323.3,600,1600,1100,2024-11-11,314,1000,0.29364214350590373
Local,Vegetables,128.0,1000,2500,1750,2024-04-29,118,1500,0.07310108509423187
Local,Vegetables,147.7,600,1200,900,2024-10-11,283,600,0.1639289678135405
Local,Vegetables,155.3,1000,4500,2750,2024-02-17,46,3500,0.056452199200290806
Local,Vegetables,159.3,700,1200,950,2025-01-22,386,500,0.16750788643533124
Local,Vegetables,167.7,500,1200,850,2025-06-24,539,700,0.1970622796709753
Local,Vegetables,171.9,1000,4500,2750,2024-09-05,247,3500,0.06248636859323883
Local,Vegetables,178.1,600,2000,1300,2024-03-21,79,1400,0.13689469638739432
Local,Vegetables,184.4,600,1400,1000,2024-12-05,338,800,0.18421578421578422
Local,Vegetables,224.3,1000,3000,2000,2024-09-22,264,2000,0.11209395302348826
Local,Vegetables,239.0,1000,3500,2250,2024-09-15,257,2500,0.1061750333185251
Local,Vegetables,274.6,600,2200,1400,2024-08-19,230,1600,0.19600285510349752
Local,Vegetables,103.1,1000,3000,2000,2024-02-26,55,2000,0.05152423788105947
Local,Vegetables,108.1,600,1200,900,2025-11-28,696,600,0.11997780244173141
Local,Vegetables,139.9,1000,3500,2250,2024-11-25,328,2500,0.06215015548645047
Local,Vegetables,160.9,1000,2500,1750,2024-04-03,92,1500,0.09189034837235865
Local,Vegetables,164.5,600,1400,1000,2024-06-11,161,800,0.16433566433566432
Local,Vegetables,166.0,1000,3000,2000,2024-02-13,42,2000,0.08295852073963018
Local,Vegetables,175.5,500,1200,850,2025-09-02,609,700,0.20622796709753233
Local,Vegetables,176.9,600,1600,1100,2024-06-21,171,1000,0.16067211625794733
Local,Vegetables,189.8,2000,5500,3750,2024-07-16,196,3500,0.050599840042655296
Local,Vegetables,191.8,2500,5500,4000,2024-06-02,152,3000,0.047938015496125974
Local,Vegetables,202.8,1000,2500,1750,2024-05-03,122,1500,0.11581953169617362
Local,Vegetables,235.8,600,1300,950,2024-07-14,194,700,0.24794952681388013
Local,Vegetables,238.8,1500,6000,3750,2024-05-19,138,4500,0.06366302319381499
Local,Vegetables,252.0,500,1200,850,2024-06-16,166,700,0.29612220916568743
Local,Vegetables,285.1,1500,4000,2750,2024-04-28,117,2500,0.10363504180298075
Local,Vegetables,286.6,500,1200,850,2024-06-23,173,700,0.336780258519389
Local,Vegetables,321.1,2000,5000,3500,2024-06-07,157,3000,0.09171665238503285
Local,Vegetables,105.3,1000,4000,2500,2024-11-27,330,3000,0.0421031587365054
Local,Vegetables,119.5,1000,3000,2000,2024-09-26,268,2000,0.059720139930034985
Local,Vegetables,125.0,1000,3500,2250,2024-07-02,182,2500,0.05553087516659263
Local,Vegetables,151.0,1500,5000,3250,2024-05-06,125,3500,0.046447247000922794
Local,Vegetables,162.3,600,1200,900,2024-04-04,93,600,0.18013318534961156
Local,Vegetables,205.0,600,1200,900,2024-02-07,36,600,0.22752497225305215
Local,Vegetables,205.5,400,1200,800,2025-10-25,662,800,0.2565543071161049
Local,Vegetables,221.2,1000,4000,2500,2024-02-20,49,3000,0.08844462215113955
Local,Vegetables,229.0,600,1200,900,2025-01-03,367,600,0.2541620421753607
Local,Vegetables,231.9,600,1500,1050,2025-02-04,399,900,0.22064700285442437
Local,Vegetables,242.2,700,1200,950,2025-02-23,418,500,0.25467928496319664
Local,Vegetables,273.6,400,1200,800,2025-08-25,601,800,0.3415730337078652
Local,Vegetables,282.4,600,1400,1000,2025-07-21,566,800,0.2821178821178821
Local,Vegetables,284.5,2000,6500,4250,2024-05-05,124,4500,0.0669254293107504
Local,Vegetables,307.4,800,1400,1100,2024-12-29,362,600,0.2792007266121707
Local,Vegetables,348.7,500,1200,850,2024-10-03,275,700,0.4097532314923619
Local,Vegetables,134.2,1500,5000,3250,2024-11-01,304,3500,0.0412796062749923
Local,Vegetables,145.3,1400,3000,2200,2024-11-26,329,1600,0.0660154475238528
Local,Vegetables,160.2,1000,3000,2000,2024-12-16,349,2000,0.0800599700149925
Local,Vegetables,171.5,600,2000,1300,2024-04-02,91,1400,0.13182167563412758
Local,Vegetables,188.6,600,1200,900,2024-02-21,50,600,0.20932297447280798
Local,Vegetables,188.7,400,1200,800,2025-03-28,451,800,0.23558052434456928
Local,Vegetables,200.0,600,1400,1000,2024-07-25,205,800,0.1998001998001998
Local,Vegetables,200.0,1500,5000,3250,2024-11-14,317,3500,0.061519532451553366
Local,Vegetables,201.0,600,2000,1300,2024-12-17,350,1400,0.15449654112221367
Local,Vegetables,210.9,600,1600,1100,2024-10-22,294,1000,0.19155313351498637
Local,Vegetables,218.7,1000,4000,2500,2024-05-24,143,3000,0.08744502199120352
Local,Vegetables,220.5,800,1700,1250,2024-01-09,7,900,0.17625899280575538
Local,Vegetables,221.3,500,1200,850,2025-11-07,675,700,0.2600470035252644
Local,Vegetables,239.3,1000,2000,1500,2024-05-16,135,1000,0.15942704863424384
Local,Vegetables,260.1,400,1400,900,2024-07-07,187,1000,0.2886792452830189
Local,Vegetables,274.0,1200,5500,3350,2024-03-24,82,4300,0.0817666368248284
Local,Vegetables,323.2,800,1400,1100,2024-07-01,181,600,0.2935513169845595
Local,Vegetables,108.6,1000,4500,2750,2024-09-16,258,3500,0.039476553980370775
Local,Vegetables,134.2,1000,2500,1750,2024-01-13,11,1500,0.07664191890348372
Local,Vegetables,142.9,600,1200,900,2025-01-01,365,600,0.1586015538290788
Local,Vegetables,142.9,600,1500,1050,2025-07-10,555,900,0.13596574690770696
Local,Vegetables,147.0,1500,4500,3000,2024-04-15,104,3000,0.048983672109296904
Local,Vegetables,174.5,500,1200,850,2024-07-11,191,700,0.20505287896592245
Local,Vegetables,193.2,2000,5000,3500,2024-01-07,5,3000,0.05518423307626392
Local,Vegetables,193.8,600,1400,1000,2025-03-20,443,800,0.19360639360639362
Local,Vegetables,194.1,600,1500,1050,2024-04-25,114,900,0.18468125594671742
Local,Vegetables,224.3,700,1400,1050,2024-03-01,59,700,0.21341579448144626
Local,Vegetables,229.0,1000,2000,1500,2024-03-19,77,1000,0.1525649566955363
Local,Vegetables,240.3,600,1500,1050,2024-04-26,115,900,0.22863939105613704
Local,Vegetables,248.9,600,1200,900,2024-03-10,68,600,0.2762486126526082
Local,Vegetables,296.6,800,1800,1300,2024-07-30,210,1000,0.22797847809377403
Local,Vegetables,300.8,1000,3000,2000,2024-11-03,306,2000,0.1503248375812094
Local,Vegetables,322.3,1000,2500,1750,2024-10-30,302,1500,0.18406624785836664
Local,Vegetables,112.5,600,2500,1550,2024-09-11,253,1900,0.0725338491295938
Local,Vegetables,143.3,600,2000,1300,2024-07-18,198,1400,0.11014604150653344
Local,Vegetables,154.8,2000,7000,4500,2024-03-13,71,5000,0.03439235725394357
Local,Vegetables,169.1,1000,1600,1300,2024-08-07,218,600,0.12997694081475789
Local,Vegetables,169.3,600,2500,1550,2024-05-21,140,1900,0.10915538362346874
Local,Vegetables,169.5,700,1500,1100,2024-04-22,111,800,0.1539509536784741
Local,Vegetables,192.2,800,1600,1200,2024-05-17,136,800,0.16003330557868442
Local,Vegetables,193.3,400,1200,800,2024-09-20,262,800,0.24132334581772785
Local,Vegetables,198.7,1200,3000,2100,2024-09-04,246,1800,0.0945740123750595
Local,Vegetables,208.0,600,1600,1100,2024-02-25,54,1000,0.18891916439600362
Local,Vegetables,208.3,500,1200,850,2025-12-12,710,700,0.24477085781433608
Local,Vegetables,225.4,600,2000,1300,2024-05-02,121,1400,0.17325134511913912
Local,Vegetables,226.7,600,1500,1050,2024-11-22,325,900,0.21569933396764984
Local,Vegetables,244.8,800,2500,1650,2024-03-17,75,1700,0.14827377347062387
Local,Vegetables,258.8,1000,1600,1300,2024-01-31,29,600,0.198923904688701
Local,Vegetables,265.4,600,1200,900,2025-11-17,685,600,0.2945615982241953
Local,Vegetables,271.8,1000,2000,1500,2024-02-27,56,1000,0.18107928047968022
Local,Vegetables,290.0,1000,2000,1500,2024-06-09,159,1000,0.1932045303131246
Local,Vegetables,330.6,1000,4000,2500,2024-05-12,131,3000,0.13218712514994002
Local,Vegetables,342.7,600,1600,1100,2024-05-22,141,1000,0.3112624886466848
Local,Vegetables,105.4,1000,2000,1500,2024-09-30,272,1000,0.07021985343104598
Local,Vegetables,111.7,2000,5000,3500,2024-07-24,204,3000,0.03190516995144244
Local,Vegetables,133.7,1500,6000,3750,2024-04-09,98,4500,0.03564382831245001
Local,Vegetables,137.5,500,1200,850,2024-06-19,169,700,0.16157461809635723
Local,Vegetables,141.7,1500,4500,3000,2024-03-08,66,3000,0.047217594135288234
Local,Vegetables,155.4,800,1600,1200,2024-01-06,4,800,0.12939217318900917
Local,Vegetables,156.0,500,2000,1250,2025-06-05,520,1500,0.12470023980815348
Local,Vegetables,175.0,1500,3500,2500,2024-05-27,146,2000,0.0699720111955218
Local,Vegetables,180.6,1000,2500,1750,2024-03-11,69,1500,0.10314106225014277
Local,Vegetables,191.5,1000,1800,1400,2024-03-29,87,800,0.13668807994289792
Local,Vegetables,216.7,600,1200,900,2024-08-06,217,600,0.24051054384017756
Local,Vegetables,224.2,1000,2000,1500,2024-12-10,343,1000,0.14936708860759493
Local,Vegetables,236.4,600,2000,1300,2024-02-29,58,1400,0.181706379707917
Local,Vegetables,237.0,1000,2000,1500,2024-06-30,180,1000,0.15789473684210525
Local,Vegetables,244.9,1500,4500,3000,2024-12-31,364,3000,0.08160613128957014
Local,Vegetables,274.5,500,1200,850,2024-02-16,45,700,0.3225616921269095
Local,Vegetables,275.3,500,1200,850,2025-08-22,598,700,0.32350176263219743
Local,Vegetables,279.8,1000,2500,1750,2024-07-28,208,1500,0.15979440319817248
Local,Vegetables,284.3,1500,4500,3000,2024-09-29,271,3000,0.0947350883038987
Local,Vegetables,285.0,1000,4500,2750,2024-09-08,250,3500,0.10359869138495092
Local,Vegetables,313.8,1000,2500,1750,2024-08-04,215,1500,0.1792118789263278
Local,Vegetables,322.3,800,2500,1650,2024-08-16,227,1700,0.19521502119927317
Local,Vegetables,330.7,600,2000,1300,2024-09-01,243,1400,0.2541890853189854
Local,Vegetables,334.3,600,1800,1200,2024-03-03,61,1200,0.27835137385512077
Local,Vegetables,400.6,800,1500,1150,2024-12-18,351,700,0.34804517810599483
Local,Vegetables,106.6,800,2000,1400,2024-05-20,139,1200,0.07608850820842256
Local,Vegetables,147.3,600,1500,1000,2024-07-09,189,900,0.14715284715284715
Local,Vegetables,175.1,1500,4500,3000,2024-08-13,224,3000,0.05834721759413529
Local,Vegetables,187.0,1000,2000,1500,2024-06-10,160,1000,0.1245836109260493
Local,Vegetables,192.7,1000,3000,2000,2024-07-12,192,2000,0.09630184907546226
Local,Vegetables,196.4,2000,5500,3750,2024-08-26,237,3500,0.05235937083444415
Local,Vegetables,199.3,600,2200,1400,2024-03-07,65,1600,0.1422555317630264
Local,Vegetables,199.6,600,1600,1100,2024-02-05,34,1000,0.1812897366030881
Local,Vegetables,205.8,600,1200,900,2025-12-09,707,600,0.2284128745837958
Local,Vegetables,216.8,600,3000,1800,2024-02-14,43,2400,0.12037756801776792
Local,Vegetables,219.1,400,1000,700,2025-01-15,379,600,0.31255349500713264
Local,Vegetables,231.6,600,1400,1000,2025-06-28,543,800,0.23136863136863137
Local,Vegetables,246.1,1000,3500,2250,2024-11-19,322,2500,0.10932918702798756
Local,Vegetables,276.2,800,2500,1650,2024-04-07,96,1700,0.16729254996971532
Local,Vegetables,320.1,600,1200,900,2024-12-15,348,600,0.35527192008879027
Local,Vegetables,331.9,600,2000,1300,2024-10-27,299,1400,0.25511145272867025
